JDX x Samuel James - Mumbai
Sebastian Ingrosso - Reload (feat. Tommy Trash & John Martin)
Borgeous Shaun Frank - This Could Be Love feat. Delaney Jane
Tiësto KSHMR - Secrets (Instant Party! Remix)
Lil Wayne - Right Above It (feat. Drake)
Colleen D Agostino Feat Deadmau5 - Stay (Will Sparks Edit)
Deorro - Five Hours [LE7ELS]
3OH 3 - Do Or Die
Alan Walker - Faded (PANI & DALTERO Bootleg)
Armin van Buuren - Ping Pong [Mix Cut] (Hardwell Remix)
Dimitri Vegas Martin Garrix Like Mike - Tremor
Firebeatz DubVision - Invincible (Radio Edit) (feat. Ruby Prophet)
Hardwell - Eclipse
Higher Self - Ghosts (feat. Lauren Mason)
Jinco - Tokyo
KSHMR Dzeko Torres - Imaginate
Martin Garrix - Animals (Oliver Heldens Remix)
Matthew Koma - One Night (Vicetone Remix)
Oliver Heldens - Koala
Krewella - Enjoy the Ride (Vicetone Remix)
R3hab KSHMR - Karate (Original Mix)
Maurice West - Blaze (Sweet Lies)
Sub Focus - Tidal Wave (feat. Alpines)
Quintino Yves V ft Gia Koka - Unbroken
Professor Green - Remedy (feat. Ruth Anne)
Steve Aoki Deorro - Be Yourself
Oliver Heldens Becky Hill - Gecko (Overdrive) [Radio Edit]
Rey Rey - BANG (K3L BOOTLEG)
Martin Garrix - Forbidden Voices
The Chainsmoker feat Halsey - Closer (Jesse Bloch Bootleg)
Dr Kucho - Can't Stop Playing (Oliver Heldens & Gregor Salto Remix)
Far East Movement - Like A G6 (feat. The Cataracs & DEV)
Steve Aoki feat Polina - Come With Me Harry J Bootleg
Lost Frequencies - Are You With Me (Dash Berlin Remix)
Kevin Rudolf - I Made It (feat. Birdman, Jay sean, Lil Wayne)
Bingo Players - Knock You Out (Hardwell Remix)
Nicky Romero vs Krewella - Legacy (Vicetone Remix)
Stadiumx Taylr Renee - Howl At The Moon
R3hab vs Skytech Fafaq - Tiger (Original Mix)
Sigma - Nobody To Love (Third Party Remix)
Blake Selby - Never Let Go ft. Twista & Sam Kay
John O Callaghan - Find Yourself (feat. Sarah Howells)
Eminem - Not Afraid (Explicit Version)
R3hab Headhunterz - Won't Stop Rocking
Oliver Heldens - Bunnydance (Original Mix)
50 Cent - New Day (feat. Dr. Dre & Alicia Keys)
Martin Garrix - Virus (How About Now)
Hardwell W W - Don't Stop The Madness (feat. Fatman Scoop)
Yeah Yeah Yeahs - Heads Will Roll (A-Trak Remix)
Tiësto Oliver Heldens - Wombass
Lana Del Rey - Young & Beautiful (Kaskade Remix)
Zeds Dead Oliver Heldens - You Know (Original Mix)
Hardwell Dyro feat Bright Lights - Never Say Goodbye
Showtek ft We Are Loud Sonny Wilson - Booyah
Calvin Harris - Outside feat. Ellie Goulding (Savagez Edit)
Kanye West - POWER
KSHMR and BASSJACKERS feat SIRAH - Memories
The Game - Red Nation (feat. Lil Wayne)
Eminem - Without Me
Dimitri Vegas - Body Talk (Feat. Julian Perretta, Moguai and Like Mike)[Radio Edit]
Sander van Doorn MOTi - Lost
Jay Pryor - All This
3LAU - How You Love Me feat. Bright Lights
Capital Cities - Safe and Sound (Dzeko and Torres Remix)
Headhunterz KSHMR - Dharma
David Guetta - Dangerous (Steve Aoki Remix)
